111111111
1000P00C1
111111111
