1111111111111111
1E000001100000P1
1C0010C100000001
100000000000C001
10000000E000CC01
1000000C10000001
1111111111111111
