111111111
1E00P00C1
111111111
