111111111
1000P0001
111111111
