111111111
1E00P00C0
111111111
